050000000000
036666666620
000000000050
016666666640
050000000000
036666666620
000000000050
016666666640
050000000000
036666666620
000000000050
000000000050
