05000000000000000000
03666666666666666620
00000000000000000050
01666666666666666640
05000000000000000000
03666666666666666620
00000000000000000050
01666666666666666640
05000000000000000000
03666666666666666620
00000000000000000050
01666666666666666640
05000000000000000000
03666666666666666620
00000000000000000050
01666666666666666640
05000000000000000000
03666666666666666620
00000000000000000050
00000000000000000050
