050000000000000
036666666666620
000000000000050
016666666666640
050000000000000
036666666666620
000000000000050
016666666666640
050000000000000
036666666666620
000000000000050
016666666666640
050000000000000
036666666666620
000000000000050
